11111111111111111111111111
10000C0000000C001C000000E1
11100010101000001000010111
10100010101100001C00011101
1C10001010011000000000C101
1010C01010C011000000000101
1C100010101001111110000001
10100010101C00000011000001
100C00000000000000C11000P1
11111111111111111111111111