111111111111111
1000000000001P1
101111011110101
101C01000C10101
1000C10C1010001
111101111011111
1001001C0C10001
10000C111110101
101111100010101
101000101010101
101010101010101
1000100010001E1
111111111111111