11111111111111111111111
10000A000000000A00000A1
1A000000000A00000000101
10001111111011111110001
10001C000C101C000C10001
1000100C0010100C0010001
100010A1A00010AEA000001
10001C000C101C000C10001
10001111111011111110001
1000000C0000000C0000001
10001111111111111110001
10001A000A0000000C1C001
10001C0000000A00001C001
10001111110001111110001
1110A0A0010001000000001
1P0000000000000000000A1
11111111111111111111111