111111111111111111111111111111111111
1A00100A0100C0100001C00000000C00A0C1
1A0000C000000000A001011A00A011A00001
1001111111111111110100C00C0000000001
1001P0000C00C000C1010111111111111101
1001111A0110A11A01010100000001AA00C1
1001C0000C000000010101010000010000C1
1001C0000C000000010101010000010000C1
1001C1100110A110A1010101A01A01101111
1001C00000000C0101010101000001A00001
1001C000A000C0C000010101000001000001
100111111111111111110101A0A0000000A1
1A0000000000A00000000101111111111111
100010000100001C00000100C00000000001
10001000A100001C0000A100C000000000E1
111111111111111111111111111111111111